1111111111111111111111711
1222112221112111222112221
1222772211722271222112221
1222112221122211222112221
1171111111117111171117171