1111111111111111111111711
1622112261116111222116221
1222772211722271262112421
1222112261122211424112221
1171111111117111171117171