11111111111111111111111111711111111111111111111111
12222222111111221111111111211112222222111111222111
12222222211112222111122222222112622222211122222211
12222222211126222211122222222112221122217242222221
12226222211222222221141111112112221122211111112221
12422222211222222261121111114112221126211111222211
12222242211122422211122222222112262222211112226211
11222222211112222111122222222111222222211112222211
11122221111111221111111222211111122221111111222211
11117111111111711111111171111111117111111111711111
11117111111111111111111111111111111111111111171111
12222222111111222111111111111112222222211111122211
12222222211112222211122222222112422226211162222221
12262224211124262227122242222712221122211162222221
12222212211222222221121111112122211112271111111421
72222111211222622221121111112172211112221111111241
12224222417222224211722222222112221122211122222221
11222222271122222111122246222112622224211122222221
11122221111112221111111222211112222222211112222111
11117111111111111111111111111111111111111117111111